        # #          
####### # # #########
#.o...# # # #..o#...#
#.#.#.# # # #.#...#.#
#.#.#.### ###.###.#.#
#.................#.#
#.#.##### ###.#.###.#
#.#...#      .#...#.#
#.#.#.# ### #.#.#.#.#
#...#.  #1# #...#...#
###.###0=2# ###P###.#
#...#.  #3# #...#...#
#.#.#.# ### #.#.#.#.#
#.#...#      .#...#.#
#.#.##### ###.#.###.#
#.................#.#
#.#.#.### ###.###.#.#
#.#.#.# # # #.#...#.#
#.o...# # # #..o#...#
####### # # #########
        # #          
